1111111111111111111111111111111111111111111111111111
1                                                  1
1                                                  1
1                                                  1
1                                                  1
1                                                  1
1                                                  1
111111111112   111111111111111111111111112   1111111
1                                                  1
1                                                  1
1                                                  1
1                                                  1
1                                                  1
1                                                  1
11111111111111111111111112   1111111111111111112   1
1                                                  1
1                                                  1
1                                                  1
1                                                  1
1                                                  1
1                                                  1
11112   1111111112   1111111111111112   111111111111
1                                                  1
1                                                  1
1                                                  1
1                                                  1
1                                                  1
1                                                  1
1111111111111111111111111111111111111111111111111111