1111111111111111111111111111111111111111111111111111
1                                                  1
1                                                  1
1                                                  1
1                                                  1
1                                                  1
1                                                  1
11111111112   1111111111111111111111111112   1111111
1                                                  1
1                                                  1
1                                                  1
1                                                  1
1                                                  1
1                                                  1
111111111111111111111112   1111111111111111111111111
1                                                  1
1                                                  1
1                                                  1
1                                                  1
1                                                  1
1                                                  1
12   111111111111111111111111111111111111111112   11
1                                                  1
1                                                  1
1                                                  1
1                                                  1
1                                                  1
1                                                  1
1111111111111111111111111111111111111111111111111111