1111111111111111111111111111111111111111111111111111
1                                                  1
1                                                  1
1                                                  1
1                                                  1
1                                                  1
1                                                  1
11111111111111111111111111111111111112   11111111111
1                                                  1
1                                                  1
1                                                  1
1                                                  1
1                                                  1
1                                                  1
1111111111112   111111111111111111111111111111111111
1                                                  1
1                                                  1
1                                                  1
1                                                  1
1                                                  1
1                                                  1
1111111111111111111111111112  1111111111111111111111
1                                                  1
1                                                  1
1                                                  1
1                                                  1
1                                                  1
1                                                  1
1111111111111111111111111111111111111111111111111111